21 21
111111111111111111111
1000000000000000000m1
111000000000001111111
101100000000000000001
100110000000001000001
100010000000001100001
100010000000000100001
100000000000000110001
111001110000000011111
100000000000000000001
100000000100000000001
100000000000000000001
111111110000000000001
100000000000010000001
100000110000010000001
100000100100010000001
100011100000011100001
100110000000000000001
100100000000000000001
100100000000000000001
1e1111111111111111111