15 17
11111111111111111
m0001111000110001
10111110011110111
10000111110000001
11110000000111101
11111111111111101
11111100000000001
11111101111111111
11111101111111111
11100000000111111
11101100111111111
11101110011111111
1111111101111110e
11111111000000001
11111111111111111